000000000000000000000000000000000000000000
000000000000000000000000000000000000000000
000000000000000000000000000000000000000000
000000000000001111100000000000000000000000
000000000000002222200000000000000000000000
111110000000000000000000000000000000000000
222221000000000000000000000000000000000000
222222111111111100000111111111111111111111
222222222222222210000022222222222222222222
222222222222222221000002222222222222222222
222222222222222222111112222222222222222222
222222222222222222222222222222222222222222
222222222222222222222222222222222222222222
222222222222222222222222222222222222222222
333333333333333333333333333333333333333333